AT1G01530       
AT1G01640       
AT1G02310       
AT1G03905       
AT1G03920       
AT1G04610       
AT1G04800       
AT1G06580       
AT1G07485       
AT1G08270       
AT1G08800       
AT1G09440       
AT1G10010       
AT1G12210       
AT1G12700       
AT1G12980       
AT1G15380       
AT1G16160       
AT1G19610       
AT1G20490       
AT1G20530       
AT1G20690       
AT1G22360       
AT1G22570       
AT1G22600       
AT1G22830       
AT1G22890       
AT1G24320       
AT1G26680       
AT1G27200       
AT1G27610       
AT1G28030       
AT1G28450       
AT1G28460       
AT1G29230       
AT1G29395       
AT1G29960       
AT1G32690       
AT1G32780       
AT1G33440       
AT1G33500       
AT1G35513       
AT1G36620       
AT1G37140       
AT1G40230       
AT1G44085       
AT1G48390       
AT1G48980       
AT1G49500       
AT1G49960       
AT1G51820       
AT1G53700       
AT1G53790       
AT1G54160       
AT1G55030       
AT1G55600       
AT1G56320       
AT1G57560       
AT1G58160       
AT1G58390       
AT1G58410       
AT1G58420       
AT1G60270       
AT1G62660       
AT1G62800       
AT1G63400       
AT1G64220       
AT1G64660       
AT1G64910       
AT1G65330       
AT1G65360       
AT1G65850       
AT1G66390       
AT1G67600       
AT1G68600       
AT1G69050       
AT1G69526       
AT1G70270       
AT1G70410       
AT1G70580       
AT1G72110       
AT1G73850       
AT1G74580       
AT1G74930       
AT1G75460       
AT1G76050       
AT1G77230       
AT1G78460       
AT1G79640       
AT1G79700       
AT1G80520       
AT1G80580       
AT2G02450       
AT2G02750       
AT2G03580       
AT2G04160       
AT2G04430       
AT2G04790       
AT2G04860       
AT2G05540       
AT2G11140       
AT2G12480       
AT2G15380       
AT2G15880       
AT2G19900       
AT2G21080       
AT2G21850       
AT2G21880       
AT2G22190       
AT2G22560       
AT2G23050       
AT2G27220       
AT2G27420       
AT2G27650       
AT2G28180       
AT2G28200       
AT2G29290       
AT2G30040       
AT2G31940       
AT2G32300       
AT2G32620       
AT2G33850       
AT2G34315       
AT2G36980       
AT2G37150       
AT2G37540       
AT2G38320       
AT2G39060       
AT2G39310       
AT2G39360       
AT2G40210       
AT2G41330       
AT2G46640       
AT2G46690       
AT2G47180       
AT3G01015       
AT3G01070       
AT3G04100       
AT3G06070       
AT3G06870       
AT3G07340       
AT3G07350       
AT3G08040       
AT3G12955       
AT3G13090       
AT3G14370       
AT3G14580       
AT3G15310       
AT3G15740       
AT3G16890       
AT3G17280       
AT3G19310       
AT3G19380       
AT3G19710       
AT3G20090       
AT3G21070       
AT3G23030       
AT3G23880       
AT3G24900       
AT3G25620       
AT3G29330       
AT3G30450       
AT3G31320       
AT3G31360       
AT3G44400       
AT3G44900       
AT3G45990       
AT3G47510       
AT3G48940       
AT3G49070       
AT3G49400       
AT3G49790       
AT3G49930       
AT3G50480       
AT3G50560       
AT3G50760       
AT3G52510       
AT3G52550       
AT3G52740       
AT3G52840       
AT3G53160       
AT3G53690       
AT3G53720       
AT3G54040       
AT3G56630       
AT3G56730       
AT3G57020       
AT3G58330       
AT3G59060       
AT3G59080       
AT3G61120       
AT3G61840       
AT3G62350       
AT3G62500       
AT4G00650       
AT4G00750       
AT4G01740       
AT4G01910       
AT4G01920       
AT4G02140       
AT4G03060       
AT4G03610       
AT4G04110       
AT4G04220       
AT4G05550       
AT4G07450       
AT4G07920       
AT4G08250       
AT4G11610       
AT4G11890       
AT4G14390       
AT4G15290       
AT4G16670       
AT4G17245       
AT4G17480       
AT4G19380       
AT4G19960       
AT4G20235       
AT4G21370       
AT4G23810       
AT4G24350       
AT4G25100       
AT4G27300       
AT4G27970       
AT4G28160       
AT4G29270       
AT4G29710       
AT4G29990       
AT4G31250       
AT4G33666       
AT4G33960       
AT4G33990       
AT4G34410       
AT4G35590       
AT4G36030       
AT4G36590       
AT4G39780       
AT5G01930       
AT5G02600       
AT5G02760       
AT5G04310       
AT5G05090       
AT5G05250       
AT5G05490       
AT5G05870       
AT5G06500       
AT5G06720       
AT5G06790       
AT5G06980       
AT5G07640       
AT5G07690       
AT5G07870       
AT5G10280       
AT5G10420       
AT5G11590       
AT5G11600       
AT5G12890       
AT5G16240       
AT5G16640       
AT5G16900       
AT5G17080       
AT5G17360       
AT5G17490       
AT5G17600       
AT5G19720       
AT5G21050       
AT5G22250       
AT5G22870       
AT5G23180       
AT5G23270       
AT5G24150       
AT5G24560       
AT5G25640       
AT5G26220       
AT5G28490       
AT5G34800       
AT5G34830       
AT5G35450       
AT5G36910       
AT5G37160       
AT5G37490       
AT5G38340       
AT5G38440       
AT5G40040       
AT5G41320       
AT5G42690       
AT5G42860       
AT5G43440       
AT5G43860       
AT5G44230       
AT5G45340       
AT5G45840       
AT5G45850       
AT5G45910       
AT5G45980       
AT5G46080       
AT5G47340       
AT5G47610       
AT5G47670       
AT5G48140       
AT5G49640       
AT5G49700       
AT5G49800       
AT5G50720       
AT5G52310       
AT5G52570       
AT5G53970       
AT5G54660       
AT5G55930       
AT5G56370       
AT5G56490       
AT5G56780       
AT5G56860       
AT5G59720       
AT5G59940       
AT5G60340       
AT5G60950       
AT5G65080       
AT5G65130       
AT5G66350       
AT5G67090       
AT5G67390       